swipe = golpe fuerte, apandar, pegar
sable = sable, negro
lenient = indulgente, lenitivo, sin lacra
sock = calcetín, media, plantilla, tortazo, pergar
stoker = fogonero
settle = resolver, establecer, liquidar, arreglar, colocar, establecer, asentar, 
slacker = vago, gandul, rácano
hump = joroba, giba, corcova, montecillo, loma, joder, llevar, llevar al hombro
thrive = prosperar, florecer, medrar, crecer mucho
inning = turno, cadencia, entrada(innings)
innards = tripas
weer = tiempo, clima
landfill = vertedero
trump = triunfo, joya, triunfar, fallar, poner un triunfo
squash = aplastar, aplastarse, apabullar, confutar, chayote, zumo, apiñadura
stead = lugar
saddle = silla de montar, sillín, lomo, puerto, faldilla, rabadilla, ensillar
tribe = tribu
penchant = inclinación, afición
apartheid = segregación racial
dead-end = callejon sin salidad
steep = empinado, escarpado, acantilado, exagerado, precipitoso, abismo
cumber = obstáculo, hacer obstáculos
bury = enterrar, sepultar, ocultar
swallow = trajar, engullir
morass = pantano, cenegal, lodazal
haul = acarrear, arrastrar, arrastrarse, transportar en, tirar algo, recorrido, tirón, trayecto, redada, botín, alijo, estirón, ganancia
ostracized = ostracismo: destierro político, exclusión voluntaria o forzosa de los cargos políticos
handicap = desventaja, minusvalía, obstáculo, estorbo, discapacidad, impotencia, perjudicar, estorbar, handicapar
staple = grapa, materia prima, corchete, principal, corriente, establecido, engrapar
stringent = riguroso, severo, tirante
swarm = ejambre, nube, multitud, hervidero, muchedumbre, pulular, enjambrar, hormiguear
takeaway = comida para llevar
shaft = eje, pozo, flecha, mango, tallo, rayo, caña, conducto, asta, caja
cast = emitir, lanzar, echar, arrojar, moldear, fundir hierro, echada, molde, elenco, lance, enyesado
orchestration = orquestación, instrumentación
zap = ¡Zaz!, borrar, ir corriendo, correr, cargarse
drone = zángano, zumbido, tono monótono, abeja, haragán, zumbar, hacer haragán, hablar monótamente
take on = asumir, tomar, aceptar, hacer, realizar, emprender, encargarse de, cargar, cargar con, ganar
take over = asumir, tomar el relevo, ocupar, tomar el control de, encargarse de, encargar, dominar, llevar, tomar posesión de
gentler = mas suave
ledger = libro mayor, libro principal, libro demostrativo
overnight = durante la noche
grumble = quejarse, refunfuñar, rezongar, regañar, retumbar a lo lejos, queja, refunfuño, ruido sordo, estruendo lejano
buckle = hebilla, pandeo, alabeo, abrochar, pandearse, buckle up: cinturón de seguridad.
dicing = cortar en cubitos
trench = trinchera, zanga, foso, hacer trincheras, atrincherar
dweller = habitante, morador, residente, gente, viviente
naughty = travieso, malo, desobediente, pícaro, atrevido
gripping = agarrando, fascinante, cautivante
shortcoming = deficiencia, defecto, falla
woes = problemas
vying = compitiendo
expunge = borrar
burst = explosión
mob = turba, multitud, grupo, pandilla, acosar, atropellar, atacar
spearhead = punta de lanza
sidekick = compañero, compinche, socio
beekeeping = apicultura
stagnant = estancado, inactivo
outward = hacia el exterior, externo, de ida, hacia afuera
ditch = zanja, foso, cuneta, arroyo, abandonar, amarar, deshacerse por, sacudirse a, abandonar a alguien
eke out = suplir las deficiencias, ganar a duras penas, tener dinero grave, hacer que llegue
grind = moler, rechinar, afilar, pulverizar, rutina, trabajo pesado
come across = venir a través de, cruzar, topar, topar con, venir, dar con, llegar, dar la impresión, ser entendido, dar la imagen, comprender
pesky = maldito
gopher = ardilla de tierra
obnoxious = desagradable, odioso, detestable
adieu = despedida
wing = ala, aleta, vuelo, volar, tocarse
gihacking = secuestro
taint = mancha, corrupción, olor, mácula, infección, tacha, manchar, contaminar
relinquish = renunciar, abandonar, dimitir de
wringing = escurrir
dig = cavar, excavar, extraer, remover, sacar a, cultivar, zanjar, hinchar, excavación, codazo
fearful = temeroso, terrible, miedoso, pavoroso, horrendo, tímido
anodize = anodizar, anodización: Técnica de protección a un metal o una aleación contra la corrosión.
struck = golpeado
affair = asunto, aventura, caso, cuestión, acontecimiento, incidente
rant = despotricar, vociferar, hablar en tono violento
unwieldy = pesado, abultado
blister = ampolla, burbuja, vejiga, producir ampollas en, cubrise de ampollas
whisper = susurrar, cuchichear, susurro, voz
hatch = escotilla, portón, ventanilla, trampa, eclosionar, incubar
drown = ahogar, ahogarse
pond = estanque, charca, balsa, vivero
scroll = desplazarse, rúbrica, rollo de papel
fierce = feroz, fuerte, intenso, violento, salvaje, furioso
crop = cultivo, cocecha, fusta, látigo, cortar, cosechar
plucking = punteo, desplume, arrancar
pluck = arrancar, desplumar, coger, puntear, depilar, robar, suspender, agallas, tirón, asaduras, plectro
crumpet = bollo, jai, jais
steer = dirigir, conducir, guiar, gobernar, buey, novillo
pique = stimulate, A feeling of irritation or resentment resulting froma a slight, esp. to one's pride
mourn = llorar, lamentar, estar de luto, llorar la muerte de, afligirse, llevar luto
scatter = dispersión, esparcir, disipar, salpicar
cubby, cubbyhole = a small room, cuchitril
dish = plato, antena, fuente, bombón, confundir, comer bombones, burlar
hearken = escuchar
disavow = desautorizar, rechazar, repudiar, desconocer
shore = apuntalar, desembarcar, escorar, orilla, costa, playa
hail = granizo, pedrisco, saludo, grito, llamada a gritos, granizar, saludar, llamar a, !salve, !hola
excel = sobresalir, exceder, aventajar, sobrepujar, sobrevenir
quarrel = reñir, pelear, regañar, quejarse
dropdown = desplegable
streamline = aerodinamizar, coordinar, línea de corriente
lit = encendido, encendio
seam = costura, veta, sutura, grieta, coser, agrietar, marcar, arrugar
fiddle = violín, estafa, superchería, trapicheo, tocar el violín, manipular, falsificar, fiddled: jugueteó
entincing = tentador
cutback = recorte, acortamiento
sworn = jurada
whopping = friolera, grandísimo, big, moster
managerial = gerencial, directivo, administrativo
stainless = inoxidable, sin mancha, inmaculado, incorrosible
groupthink = pensamiento de grupo
chase = persecución, caza, perseguir, cazar, correr
bond = fianza, bono, enlace, obligación, conexión, deposito, ligadura, esclavo, garantizar
tightrope = cuerda de equilibrista
sufferer = víctima, enfermo, doliente
stomp = pisar muy fuerte
darn = maldito, zurcido, zurcir, maldecir
spite = despecho, ojeriza, malevolencia, mortificar, herir, causar pena a
poring over = estudiando detenidamente
drum = tambor, bidón, barril, bombo, timbal, teclear, tamborilear, tocar el tambor, zapatear
plunge = caída, zambullida, inmersión, baño, sumergirse, lanzarse, hundir, jugar, fuerte, ser muy escotado
compel = obligar, compeler, empeñar, imponer en
draw = dibujar, sacar, llamar, extraer, atraer, hacer, tomar, retirar, empate, sorteo
dub = doblar, apodar, armar caballero, vestir caballero, dubbed: denominado
deck = cubierta, baraja, piso, platina, suelo, plataforma, adorno, diestro en, engalanar
hoop = esperanza
snippy = insolente
lukewarm = tibio, displicente
pronged = frentes
acquaint = familiarizar, informar, poner al corriente
compliance = conformidad, obediencia, sumisión
spawn = desovar, engendrar, freza, huevas, prole, semillas
goat = cabra, macho cabrío
cram = atiborrar, atestar, rellenar con
welfare = bienestar, asistencia social, bien, benefactor
fingertip = punta del dedo
clumsy = torpe, tosco, desmañado, chapucero
belt = cinturón, correa, faja, cinto, zona, ceñir, pegar con una correa
deceive = engañar, burlar, defraudar, equivocarse, estacar, capear, pavonearse
pill = pilldora
shitload = chingo
cull = deshecho, entre sacar, escojer
heartfelt = sentido, cordial
crush = aplastar, triturar, machacar, abrumar, apabullar, exprimir, fracasar, aglomeración, caída, infatuación, crecimiento urbano
runner up = finalista
stumble = trastabillar, dar un traspié, tropezar por, traspié, tropezón
fond = fondo, aficionado
outrageous = indignante, escandalozo, atroz, terrible, monstruoso
crave = pedir, implorar, apetecer, rogar a
tear = rasgar, arrancar, desgarrar, despedazar, partir, deshacerse, rasgón, lágrima
umpteen = tantísimos
tip = punta, consejo, propina, extremidad, boquilla, yema, vertedero, aviso, soplo, chivatazo, contera, recomendar
boilerplate = repetitivo
quirk = capricho, peculiaridad, rasgo, ocurrencia, escapatoria, mediacaña
reassurance = seguridades, alivio, promesa tranquilizadora, aseguro, noticia tranquilizadora
reassure = tranquilizar, reasegurar, alentar
chuckle = reírse entre dientes, soltar una risa, risita, risa contenida, risa sofocada
astray = por el mal camino, descarriado, perdido
stray = perderse, extraviarse, errar, vagar en, extraviado, errante
runaway = fugitivo, desertor
ostrich = avestruz
scorn = desdeñar, desden
scornful = desdeñoso, despreciativo
dugout = refugio subterráneo
rehearsal = ensayo, enumeración
cold = frío, resfriado, gris, dañoso, catarro, constipado, totalmente
stomach = estómago, vientre, deseo querido, aguantar, trabajar
lining = forro, revestimiento, cambio, cambio de ropa
boasts = cuenta con, del verbo boast
boast = jactarse, presumir de, alardear, ufanarse, alabarse, vanagloriarse de tener, alarde, jactancia
mint = menta, casa de moneda
vilify = vilipendiar: despreciar[una cosa], denigrar[a una persona]
tinker = gitano, remedar, manosear, tratar de reparar, jugar en, remedar mal, estropear, remedoón, pícaro
forthcoming = próximo, venidero, en preparación, disponible, comunicativo, abierto, afable, aproximación
detachment = separación, desapego, imparcialidad
crumble = desmoronarse, desmenuzar, caer, desmigar
nifty = hábil, elegante, ágil, muy pera, experto
blurry = borroso
pity = lástima, compasión, tener lástima
pitiful = lamentable, lastimoso, despreciable
hideously = horriblemente, feamente
flurry = ráfaga, agitación, aturdimiento, estado nervioso, agitar
swirl = remolino, torbellino, arremolinarse
stitch = puntada, punzada, punto de sutura, coser, suturar
unravel = desenmarañar, desenredar, descifrar
fore = delatero, anterior, de proa, adelante, frente, ¡atención!
yell = gritar, chillar, vociferar, dar voces, decir a gritos, alarido, chillido
flare = llamarada, bengala,  cohete de señales, proyectil de iluminación, encenderse, llamear, abocinar
bout = combate, ataque, asalto, contienda, rato, turno
spurious = espurio, falso
affair = asunto, aventura, caso, cuestión, acontecimiento, incidente, lance, duelo, movida
dread = terror, pavor, horror, monstruo, temer, tener miedo, terrible, espantoso, horrible, pavoroso
rehearse = ensayar, enumerar, repetir algo
lightning = relámpago, agilidad, poco peso, levedad
glow = brillo, luz, incandescencia, ardor, arrebol, color vivo, sensación de bien estar, sensación grata, brillar, resplandecer
chatterbox = parlanchín, charlatán, trápala
stunning = maravilloso, estupendo, pasmoso, que aturde
grapple = luchar, agarrar, aferrarse, asir, aferrar, lucha, cierre, gafa
abreast = a la par, de frente, en la fila, uno a lado del otro
forfeit = perder, perder el derecho a, pérdida, multa, prenda, pena, confiscado
thrill = emoción, estremecimiento, sensación, emocionar, estremecer, emocionarse
outage = corte
capstone = pieda arquitectónica
sheer = puro, escarpado, total, mero, absoluto, completo, completamente, perpendiculamente, cair a pico
bore = agujero, taladro, calibre, aburrir, perforar, taladrar, barrenar, horadar
starving = hambriento, famélico
cheek = mejilla, carrillo, descaro, nalga, desfachatez
deem = considerar, estimar, creer, juzgar algo
lingering = lento, prolongado, persistente, fijo, que no se desvanece
daft = chiflado, loco, bobo, tonto como un asno
kluge(german) = clever, sabio
spinning = hilado, rotación, hilandería, arte de hilar, de hilar, girante
clang = sonido metálico, estruendo, sonar, hacer sonar, hacer estruendo
wrongdoer = malhechor
tenant = inquilino
wedge = cuña, porción, calce, pedazo, calza, acuñar, calzar, mantener, mella
gush = chorro, borbotón, torrente, afectación, sentimentalismo, efusión exagerada, chorrear, borbotar, salir a borbollones
jibe = pullas, burla, escarnio, dicterio, mofarse, burlarse, hablar atropelladamente
lofty = elevado, alto, noble, sublime, grandioso, orgulloso
brook = arroyo, quebrada, soportar, aguantar
hunch = corazonada, pálpito, sospecha, premonición, encorvar, llevar, coger, joder
jitter = estar nervioso
pique = stimulate, A feeling of irritation or resentment resulting from a slight, esp. to one's pride
mindless = sin sentido, imbécil, inconsiente de
funnel = embudo, canalizar, concentrar, acanalar
heretofore = hasta ahora
stem = vástago, tallo, tronco, pie, restañar, rechazar, refrenar, steams: derivar
guilt = culpa
fumble = manosear, dejar caer, buscar a tientas, revolverse, manoseo
grip = apretón, empuñadura, asimiento, agarro, agarrar, agarrarse, apretar
wander = paseo, bajar, deambular, recorrer
wandering = errante, ambulante, nómada, sinuoso, bagabundeo, extravío
oddly enough = por extraño que parezca
asset = baza: número de naipes que se utilizan en cada jugada y se echan sobre la mesa y que recoge el jugador ganador, posesión capital
steady = estable, firme, sensato, continuo, estabilizarse, mantenerse firme, novio, !con calma, !despacio
reel = carrete, bobina, rollo, película, tambalear, devanar, tambalearse a,
cejar, retroceder a 
slew = montón, girar, torcer, dar un giro, torcerse a
chore = faena, trabajo rutinario, tarea jornal
rambling on = divagando
scarcity = escasez, rareza
shout = gritar, vociferar, grito
blunder = meter la pata, chapucear, cometer una torpeza, pifiar, torpeza, disparate
slicing = rebanar
readiness = preparación, disponibilidad, buena disposición, prontitud
jettisoned = desechado
meander = meandro, serpentear, divagar, vagar a
summon = convocar, llamar, citar, pedir, evocar
inking = entintado
foothold = punto de apoyo, asidero para el pie, cosa para el pie
headed = encabezada, con membrete, repolludo
bail = fianza, asa, arco, achicador, muro exterior, barra que separa los compartimientos de un establo, bail out: rescatar, sacar de apuro
squeeze = apretar, exprimir, presionar, apretón, presión
shrug = encogimiento de hombros
wieldy = manejable
rubber = caucho, goma, hule, condón, goma de borrar, juego, paño de pulir, de goma, cubrir de goma
hustler = estafador, timador, puta, ramera
stealth = sigilo, cautela
audit = auditoría, revisión, ser oyente
whereupon = despues de lo cual
rotten = podrido, corrompido, carcomido, malísimo, pasado
twitch = tic, movimiento, contracción nerviosa, tirón, sacudida, crispar, crisparse, moverse nerviosamente, retorcer
tenet = principio, dogma, canon
allegedly = pretendidamente
inception = comienzo, principio, empiezo
ripe = maduro, listo, perfecto, fuerte, grosero
fairness = justicia, rectitud, hermosura
cue = señal, taco, apunte, taco de billar, indicación convenida
aced = lució, lucirse
bite = morder, picar, atacar, penetrar, agarrarse, mordedura, mordida, picadura, bocado, agarre
delve = profundizar, ahondar, cavar, investigar hasta, investigo
ramble = divagar, serpentear, enredarse, caminata, excursión a pie
gently = suavemente, dulcemente, despacio, poco a poco, tiernamente, dócilmente
dreadful = terrible, espantoso, horroroso,  pavoroso, pésimo, malísimo
doom = condenado, perdicion, muerte, final, destino amargo, condenar, predestinar
endeavor = esforzarse, tratar de, tentar a, esfuerzo, empeño, tentativa, tratamiento
taking over = hacerse cargo
multifold = múltiple
sharpness = nitidez, agudeza, afilado, intensidad, aspereza, brusquedad, severidad
ballot = votación,  papeleta, balota, sorteo, lista de candidatos, votar, sortear, invitar a votar
slog = babosa, lingote, posta, ficha, aporrear, pegar
fidgeting = inquietud
fidget = agitarse, menearse nerviasamente, poner nervioso, ser un azogue, persona inquieta
sigh = suspirar, suspiro
tidbit = a small piece of tasty food, a small and particulary item of gossip or information. Syn: titbit, dainty, delicacy
slap = bofetada, palmada, manotada, paliza, abofetear, golpear, dar una palmada, pegar
goof = bobo, mentecato, meter la pata, tirarse una plancha
frown = fruncir el ceño, desaprobar, encapotarse
wrangle = disputa, reñir a, reñir por
relief = alivio, socorro, relieve, relevo, desgravación, desahogo, consuelo
procrastination = dilación, morosidad
pundits = expertos
shortage = escasez, falta, déficit, carencia, carestía, crisis
fridge = nevera, heladera, frigo, refrigeradora
compelling = irresistible
sneaky = furtivo, sigiloso, soplón
lore = ciencia, tradiciones, saber popular
yummy = sobroso, de rechupete
convolute = retorcer, convoluted: complejo
purse = bolso, monedero, cartera, portamonedas, premio, colecta, fruncir, apretar
hobble = cojear, maniatar, andar cojeando, manear, renguear, mancornar, cojera
fulfillment = cumplimiento, reslización
endow = dotar, crear, fundar
drunken = borracho
tickler file = Is a collection of date-labeled file folders.
hike = caminata, aumento, marcha, excursión a pie, ir de excursión, aumentar, dar una caminata, ir a pie, subir por, ir andando
portend = presagiar, anunciar
warrant = orden, autorización, garantía, mandato, mandamiento, justificar, asegurar
collate = cotejar
pool = piscina, estanque, pileta, fuente, aunar, mancomunar, juntar, reunir, consociar, poner en un fondo común
booth = cabina, puesto
worn = usado, deteriorado, pasado, andado
outright = total, completo, franco, declarado, definitivo, entero, abiertament, francamente, de una vez, de un golpe
retort = réplica, retorta, replicar, devolverse
dull = aburrido, sordo, mate, embotado, apagado, torpe, gris, pálido, pesado, romo, obtuso, sombrío
stump = muñón, tocón, cabo, religón, poste, dejar perplejo a, desconcertar en algo
crowd = multitude, mochedumbre, grupo, llenar, apiñar, estrujar
chuck = arrojar, echar, encajar, tirar en, abandonar, mamola, tiro, echada
mourning = luto, duelo, lamentación, de luto
partake = participar, tomar parte
pitch = tono, paso, campo, brea, inclinación, pez, pendiente, resina, lanzar
suitor = pretendiente, demandante, postulante, pleiteador
appealing = atractivo, suplicante, conmovedor
lump = bulto, masa, terrón, pedazo, grumo, chichón, hichazón, pella, englobar
windfall = ganancias inesperadas
bog = pantano, ciénaga, fangal
creep = arrastrarse, reptar, arrastrar, deslizar, cobista, persona repugnante
creepy = horripilante, pavoroso
indulge = satisfacer, complacer, consentir, dar rienda suelta, mimar, gratificar, beber, tomar el perdón, disfrutar
harness = aprovechar, utilizar, enjaezar, explotar, enganchar, dominar a, ser dominio, arneses, arreos
spew = arrojar, echar fuera, vomitar a uno
jilt = dejar plantado, dar calabazas
warfare = guerra
dashboard = salpicadero, tablero de instrumentos, tablero de pizca
bandwagon = carro, partido político que triunfa, carro de la banda musical
ought = debería, deber
batter = bateador, pasta, defecto, estropear, azotar, golpearse, apalear, magullar
still = todavía, aún, inmóvil, quieto, sin embargo, con todo, a pesar de que, calmar, aquietar, acallar
gripper = pinza
utter = total, absoluto, completo, cabal, puro, pronunciar, proferir, expresar, expender, publicar, dar a
wipe = limpiar, secar, enjugar, secar los platos, limpión, limpiadura, enjugador, cate, lapo
woefully = lamentablemente
wherewithal = medios, el cumquibus 
wings = bastidores
bargain = oferta, ganga, negocio, trato, convenio, negociar, trocar, ofrecer
catch on = hacerse popular, alcanzar gran popularidad, popularizarse, percibir, caer
chest = pecho, tórax, cofre, arca
dump = arrojar, deshacerse de, descargarse, vaciar en, volcar dentro, verter a, vertedero, tugurio, montón
snoring = ronquidos
bollocks = cojones, chorradas
frill = volante, lechuguilla, faralá, escarolar, adorno
earnest = serio, formal, fervoroso, prenda, mando
beg = mendigar, pedir limosna, rogar a, suplicar a, exigir, dar una excusa
flaky = escamoso, desmenuzable
offload = descargar
lax = laxo, flojo, poco exigente, indisciplinado
oust = expulsar, echar, desalojar, desahuciar
lend = prestar, dar, dejar, emprestar, darse, añadir, quitar
grut = gruñido, suelo, gruñir, estar en el suelo
kumquat = naranja, china
dart = dardo, flecha, rehilete, lanzarse, precipitarse, flechar, sisar, hacer precipitaciones
ensemble = juntos
fed up = harto
since ever = desde siempre
invoice = factura
envision = imaginar, guardar
take = tomar, cojer, llevar, asumir, opinion
trail = sendero, rastro, camino, pista, rastrear, caminar
trailblazer = Una persona que marca un sendero através de áreas silvestres
indoctrinate = adoctrinar, hacer doctrinas
moats = fosos
glean = espigar, recoger
stand = estar, estar de pie, tolerar, encontrarse, posición, parada, postura
slid = se deslizó
spike = espiga, punta, clavo, clavar, rechazar
disregard = ignorar, desatender, pasar por alto, indiferencia, descuido
fasten = fijar, sujetar, atar, abrochar, abrocharse, cerrar, pegar
kidnap = secuestrar, raptar
gloom = oscuridad, penumbra, tristeza, pesimismo, estar en penumbra
bid = oferta, intento, puja, postura, declaración, invitación, pujar, ofrecer, rogar a
wither = marchitar
throughput = rendimiento
swarm = enjambre, nube, multitud, hervidero, muchedumbre, pulular, enjambrar
breathe = respirar, aspirar, espirar, vivir
cockpit = carlinga, cabina de piloto, ruedo, reñidero de gallos, gallería
siege = cerco, acoso, calvario
bode = presagiar, predecir, agorar
hefty = fuerte
shallow = superficial, poco profundo, poco, llano
I look forward = Espero con interés.
handwritten = escrito
slam = golpe, bola, golpear, cerrar de golpe
heir-in-waiting = heredero de honor
deflect = desviar, cambiar, desviar sobre
knell = toque de difuntos, doble
crumple = arrugarse, estrujar, estropear, deshacer, rabosear
spur = estimular, espolear, estímulo, espuela, estribo
gauge = medir, calibrar, estimar, calibre, indicador
pulling = tracción, tirada de fusil
spike = espiga, punta, pincho, clavo, estaquilla, clavar, rechazar
catch up = ponerse al día
sibling = hermano
whatsoever = todo lo que, lo que, cualquier cosas
cope = hacer frente a, enfrentarse con, capa pluvial
crisper = más nítidas
soothing = calmante, tranquilizador, dulce, analgésico
to wit = esto es
wit = ingenio, saber, inteligencia, agudeza, talento, gracia, juicio, sal, chistoso, persona ingeniosa
seize = aprovechar, apoderarse, agarrar, embargar, coger, captar
chase = persecución, caza, carrera, alcance, perseguir, cazar, correr, seguir, ahuyentar, cincelar
ripple = onda, rizo, murmullo, susurro, ondular, rizarse, rizar
rebond = rebote, rechazo, rebotar, repercutir, dar un rebote
ilk = primero
utmost = mayor, más lejano, extremo
proband or propositus = is a term used most often in medical genetics and other medical fields to denote a particular subject(person or animal) being studied or reported on.
gulp = trago, sorbo, tragar saliva, engullir
grave = grave, tumba, sepultura
hassles = molestias
parlor = salón, locutorio, sala de recibir
dummy = maniquí, muñeco, muerto, tonto, chupete, vacío, falso, postizo, de error
bid = oferta, intento, puja, postura, declaración, pujar, ofrecer, mandar, rogar a
breakthrough = progreso, ruptura, penetración
clerk = empleado, secretario, oficinista, funcionario
milepost = mojón, poste miliar
harassment = acoso, hostigamiento
crank = manivela, cigüeñal, manubrio, maniático, dominio de manubrio, dar una vuelta a
beef = (beefs: refuerza) carne de res, carnde de vaca, res, ganado vacuno, queja, corpulencia, fuerza muscular, quejarse
knack = truco, maña, tranquilo, tino
bitter = amargo, acerbo, ácido, cerveza amarga
velvet = terciopelo
slick = mancha, capa, marea negra, mancha flotante, hábil, astuto, mañoso, rápido
lieu = lugar
spin = airar, hilar, contar, bailar, devanar, dar vueltas sobre, efecto, barrena
thus far = hasta ahora
floodlight = foco
pun = juego de palabras
so to speak = por decirlo así
oblivious = inconsciente de, de poca memoria
debatable = discutible
nurture = nutrir, alimentar, criar, educar, crianza, educación
backwater = remanso, agua estancada, lugar apartado, ciar
starling = alarmante, asombroso, sobrecogedor, llamativo, chillón
hamper = estorbar, impedir, poner obstáculos, cesto, canazto, canasta, capacho
cathartic = catártico, purgante, proceso de limpiar almas
clout = influencia, fuerza, tortazo, dar un tortazo
vessel = buque, recipiente, vaso, barco, vasija, bajel
balk = obstáculo, viga, caballon, cabaña, negarse, frustrar, obstaculizar, evitar
heartless = cruel, insensible, inhumano, empedernido
appalling = espantoso, pésimo, aterrador, asombroso
villain = villano, malo, malvado, bribón, infame, criminal, traidor, ladrón, tunante
elicit = obtener, provocar, sonsacar
tire = neumático, llanta, cubierta, cámara, calce, rueda de goma, cansarse, cansar, fatigar, aburrir
begrudgingly = a disgusto
heel = tacón, calcañar, talonear, desatento talón
conceal = ocular, esconder, disimular, encubrir
obtuse = obtuso, estúpido
glitches = problemas técnicos
fleet = flota, veloz, fugaz(fleeting)
gist = esencia, sentido, razón
morsel = bocado, pedazo, fragmento
thimble = dedal
insofar = en la medida
foreboding = presentimiento, pensamiento
foxtrot = a type of dance
arguably = podría decirse que
snazzy = elegante
glossy = lustroso
peer = pares, par, igual, mirar, mirar con atención, aparecer, elevar a la dignidad de par, compañero
surgery = cirugía, consultorio, clínica, gabinete de consulta
surgeon = cirujano, médico
hot off = recien salido de
attain = alcanzar, lograr, conseguir, llegar a, realizar
dew = rocío, gota, lágrima
tandem = tándem: Bicicleta para dos personas que dispone de 2 sillines colocados uno detrás del otro, Tiro de dos caballos enganchados uno tras el otro.
ballpark = estadio de béisbol
footstep = paso, pisada
punch = ponche, puñetazo, perforadora, fuerza, pegada, sacabocados, energía, golpear, taladrar, dar un puñetazo, aguijonear
wildderness = desierto, yermo
heck = infierno, interjección ¡demonio
hatred = odio, detesto
rusty = oxidado, enmohecido, aherrumbrado, color de orín
fleeting = fugaz, efímero, pasajero, rápido
awry = torcido, desviado, de través, desviadamente, torcidamente
ruthless = despiadado, implacable, inexorable
livelihood = sustento
brief = breve, corto, conciso, muy corto, instrucciones, sumario, expediente, informar, resumir, dar instrucciones a
ancillary = auxiliar, secundario, anexo, subordinado, afín
seldom = raramente, my pocas veces
fright = susto, espanto, terror, sobresalto, horror, espantajo, estantigua
gimmick = truco, artilugio, asunto
truthfully = a decir verdad
seltzer = agua de Seltzer
chipping away = minando
buggy = in software: Refers to software that contains many flaws. A small, light, one-horse carriage usually having four wheels in the United States and two wheels in Great Britain.
shocking = chocante, escandaloso, espantoso, horrible, aterrador, muy, muy mal, de manera chocante
blurb = propaganda, palabrería
crap = mierda, estupideces, cagada, cagar
bund = traste, alianza, confederación, unión, vínculo, liga, coalición, cintura, pretina, ristra, haz
bundling = agrupación
summit = cumbre, cima, colmo, pináculo, conferencia de alto nivel
telecommuting = teletrabajo
afar = lejos
arouse = despertar, excitar, despertarse
suspicion = sospecha, recelo, dejo, traza ligera
harry = Persistently carry out attacks on, Persistently harass.
bathwater = agua de la bañera
bloom = florecer, resplandecer, floración, florecimiento, flor, eclosión, brillo, color encendido, vello, desbaste, aroma
blooming = floreciente, radiante de salud
tuck = pliegue, alforza, golosinas, provisiones, dulces, comer, arropar, plegar, zamparse, plegarse
tucked = escondido
hive = colmena
runaround = contorneo
staffer = miembro del personal
ream = resma(conjunto de quinientas hojas o pliegos de papel), montón, escariar(agrandar o redondear[un agujero o el diámetro de un tubo]).
rambling = laberíntico, trepador, enmarañado, divagador, prolijo y confuso, sin plan
meandering = serpenteante, con meandros, incoherente, largo y confuso
tax = impuesto, contribución, exigir, abusar
standby = en espera
newfangled = novedoso
frazzle = agotar, reventar sobre, rendir
verbatim = palabra por palabra, literal, literalmente
pinch = pellizcar, apretar, pillarse, robar, agarrar, coger, quitar, escatimar, mangar, pellizco, pizca
telcos = las empresas de telecomunicaciones
bare = sólo, desnudo, pelado, simple, vacío, escaso
bundle = liar, poner desordenadamente, haz, manojo, bulto, lío, fajo, ramillete, envoltorio
hardworking = trabajador
downtime = tiempo de inactividad, falta del tiempo
beware = tener cuidado, guardarse de, ¡atención
tap = aprovechar, pulsar, explotar, utilizar, pinchar, conectar, interceptar, grifo, golpecito, llave, derivación
landline = teléfono fijo
iffy = dudoso
ace = as, experto
lure = atraer, seducir, tentar a, entruchar, señuelo, atractivo, cebo, aliciente, engaño, anzuelo, encanto, placer
gotcha = I have got you(used to express satisfaction at having captured or defeated someone or uncovered their faults), trampa
lackluster = deslucido, deslustrado, apagado, inexpresivo, pesado
backbone = columna vertebral, espinazo, lomo, carácter
sample = muestra, espécimen, probar, tomar una muestra, catar
broker = corredor, agente de bolsa, agente comercial
spell out = explicado
better off = mejor, más rico
bond = enlace, fianza, bono, obligación, conexión, depósito, ligadura
bypass = evitar, pasar, sobrepasar, pasar de, desviar en, adelatarse a otro auto
rackmount = para montaje en rack
highest-end = de gama más alta
shovel = pala, excavadora, mover con la pala, echar con la pala
plead = alegar, abogar, implorar, declarar, peitear, defender a
bear = oso, bajista, llevar, soportar, tener, portar, dar a luz, parir, aguantar, sostener, guardar
shamble = andar arrastrando los pies
choir = coro, coral, orfeón, cantar a coro
splice = empalme, junta común, empalmar, ayustar, juntar a
onstage = en el escenario
cloudburst = chaparrón, chubasco
spill = derramar, derrame, verterse, hacer caer, vertido, vuelco, caída
one-upped = al próximo nivel
aim = objetivo, fin, propósito, meta, puntería, apuntar, aspirar, pretender, proponer, lanzar, asestar
carve = esculpir, labrar, trinchar, dividir, cincelar, tallar a, trinchar el carne
unheard = inaudito
hut = choza, cabaña, barraca, borda, cobertizo, casilla, albergue de montaña
engulf = sumergir, tragarse, sumergirse
sway = balancearse, sacudir, merecerse, mover, inclinar a, menearse, influencia, sacudimiento, poder
cutlet = chuleta, chuleta de ternera, carne para chuleta
noodle = fideos, cabeza, bobo
cripes = used to express annoyance, anger, or dismay
liveliness = vivacidad, viveza, animación, vida, alegría, energía, entusiasmo, interés
peg = clavija, espiga, estaca, gancho, estaquilla, pata, enclavillar, estabilizar, marcar
necklace = collar
platoon = peloton
dug = excavado, teta, ubre
sage = salvia, sabio, sensato
likened = comparado
stir = revolver, remover, moverse, estimular, incitar, conmover, atizar, emocionar, agitación, conmoción, sensación
blame = culpa, censura, culpar, censurar
will = voluntad, albedrío, testamento, placer, deseo, talante, querer, legar, dejar un testamento, ordenar, sugestionar, lograr por fuerza de voluntad
draw out = sacar, alargar, arrancar, estirar, sonsacar, tirar, hacer hablar, redactar, retirar dinero
shield = escudo, blindaje, protección, placa, pantalla protectora, capa protectora, careta, protejer, blindar, escudar, tapar
harbor = puerto, albergue, hospedaje, albergar, abrigar, hospedar, esconder, dar abrigo, amparar, ocultar, dar asilo
cage = jaula, caja cerrada, enjaular, captar, presionar
tag = etiqueta, marbete, chapa, herrete, muletilla, seguir de cerca, pisar los talones a, poner una etiqueta a
hold = mantener, celebrar, sostener, tener, contener, retener, sujetar, ocupar, guardar, soportar, resistir, asimiento
toad = sapo
shape up = ponerse en forma
measly = miserable, mezquino
undergo = someterse, experimentar, padecer
bound = obligado, ligado, encuadernado, confinado, inmovilizado, límite, bote, botar, moverse dando saltos
mad = loco, furioso, demente, rabioso, insensato, chiflado, disparatado, chalado
latch = pestillo, cerrojo, picaporte, aldaba, asegurar, cerrar con picaporte, cerrar con pestillo
guts = agallas, tripas, valor, coraje, meollo, carácter, sustancia, aguante
instill = instilar, inculcar lentamente
slimy = baboso, limoso, legamoso
roam = vagar, recorrer, vagar por, pegar, vagabundeo
sleeve = manga, manguito, portada, enchufe
strew = esparcir, derramar, cubrir, sembrar
hideout = escondite, escondrijo
spotting = manchado, moteamiento
stricken = afligido, condenado
reckless = temerario, atolondrado, peligroso, osado, inconsiderado, excesivo, atronado
uproar = escándalo, tumulto, estruendo, bullicio, algazara, gritos, gresca, ginebra, balumba, trápala
fuss = escándalo, aspavientos, lío, jaleo, protesta, bulla, alharacas, preocuparse, molestar, agitarse
doorstep = puerta, escalón, peldaño
shroud = sudario, mortaja, velo, obenque, envolver, ocultar, amortajar
stake = estaca, hoguera, poste, puesta, rodrigón, parada, apostar, estacar, poner, aventurar, envarar, in stake: en juego
fence = valla, cercado, seto, estacada, cercar, esgrimir, proteger, defenderse, guardar, hacer esgrima
sitter = modelo, blanco facilícimo, gol facilícimo, gallina culeca, persona que cuida a los niños enfermos
geezer = vejestorio, tío
pin = perno, clavija, alfiler, broche, chaveta, rodillo, pinza, pin down: precisar, inmovilizar, sujetar a la fuerza, obligar a concretar
slug = babosa, lingote, posta, ficha, pegar, aporrear, 
impudent = insolente, inpudente, descarado, lanzado, desmesurado
brat = mocoso, palo de golf, graghillas
verge = borde, margen, vera, acercarse, acercar, rayar en
worthless = sin valor, indigno, mandria, inútil
jerk = tirón, sacudida, pelmazo, espasmo, memo, sacudirse, tironear, idiota
culprit = culpable, reo, delincuente, culpado
aback = detrás, atras, en facha, encapado
scream = gritar, chillar, vociferar, berrear, chirriar, chillido, cosa o persona muy graciosa
reap = cosechar, recoger, segar
shut = cerrar, cerrarse, encerrar, cerrado, shut out: excluir, dejar fuera, evitar, evitar la entrada
voyage = viaje, pasaje
sail = navegar, salir, gobernar, volar, marchar, ir en barco, planear, vela, velero, travesía, paseo, velamen, set sail: zarpar
sailor = marinero, marino
deckhand = marinero
shabby = lamentable, raído, andrajoso, mezquino, desarrapado, mal entrazado, trapajoso
stingy = tacaño, amarrado, guardador
upset = alterar, perturbar, alterarse, volcar, preocuparse, derribar, trastorno, vuelco, contratiempo, revés, acongojado
weave = tejer, entrelazar, urdir, tramar, abrirse, evadir, tejido, textura
nuisance = molestia, fastidio, estorbo, perjuicio, lata, incomodidad, daño, pesado, pelmazo
sturdy = robusto, fuerte, vigoroso, tenaz, enérgico
withstand = resistir a
match = partido, igual, encuentro, cerilla, casamiento, mecha, concurso, igualar, emparejar, armonizar, hacer juego con
rod = barra, vara, caña, biela, jalón
snap = chasquear, romper, castañetear, tomar una foto, romperse con, querer morder a uno, chasquido, instantánea, foto, golpe seco, mordisco, automático
stubborn = obstinado, terco, tenaz, obcecado, duro, inquebrantable
showy = llamativo, ostentoso, aparatoso, cursi, gayo
bait = cebo, carnada, anzuelo, señuelo, cebar, hostigar, azuzar
row = fila, hilera, renglón, vuelta, bronca, hilada, pasada, remar, bogar
grudge = envidiar, escatimar, dar de mala gana
bushy = tupido, breñoso, parecido a un arbusto
brow = frente, ceja, cima, cara
wimp = endeble
dock = muelle, dique, banquillo, acedera, romaza, atracar, acoplar, llegar, ensamblar, recortar, descolar
herb = hierba
trove = tesoro
remnant = residuo, retazo, resto
leftover = sobrante, restante, resto, izquierdista, superviviente
undertake = emprender, comprometerse, acometer, encargarse de, prometer
stash = esconder, alijo, escondite
harvest = cosecha, recolección, siega, vendimia, cosechar, recolectar, segar, esquilmar
newt = tritón
numb = adormecer, adormecido
beat = batir, vencer, derrotar, golpear, ganar, latir, mejorar, superar a, pegar
mud = barro, lodo, cieno, lodazal, lama
bruise = contusión, moretón, magulladura, herida, daño, herir, magullar, machucar
sprain = esguince, torcedura, desgarro, torcer, torcerse
stall = puesto, establo, casilla, caseta, pararse, buscar evasivas
gamble = jugar, arriesgarse, especular, aventurar, riesgo, jugada, empresa
sink = hundirse, hundir, caer, sumirse, disipar, bajar, fregadero, lavado
farewell = despedida, ¡adiós, ¡para siempre
farfetched = inverosimil, highly imaginative but unlikely
literacy = alfabetismo, saber leer y escribir, conocimiento práctico
slash = acuchillar, atacar, machacar, tirar tajos, barra oblicua, cuchillada, cortada
fog = niebla, bruma, confusión, empañar, velar, enturbiar
thick = espesor, grueso, espeso, denso, tupido, gordo, cerrado
friar = fraile, fray
kind = tipo, clase, especie, modo, caracter, amable, bueno, bondadoso, benigno, cariñoso
crow = cuervo, corneja, canto, grajo, grazna, factarse de, hacer alarde
ash = ceniza, fresno
lurk = estar al acecho
crab = cangrejo, cáncer, cámbaro, fallar con el remo, quejarse, dar una calada
barnacle = percebe, lapa, barnacla
bristle = cerda, erizar, poner de punta, estar repleto
threat = amenaza, espanto
comrade = camarada, compañero, amigo, contemporáneo
rud = timón, gobernalle
spring = primavera, resorte, muelle, manantial, fuente, elasticidad, brotar, brincar, volar, torcer, levantar
replenish = reponer, rellenar, reaprovisionar, repostar
slaughter = masacre, matanza, carnicería, sacrificar, matar, carnear
grin = sonreír, ponerse sorisa, sonrisa, mueca
yield = ceder, producir, dar, ofrecer, ceder el paso, entregar, someterse, dejar, rendimiento, producción, cosecha
soak = remojar, empapar, empaparse, remojarse, desplumar, beber mucho, borrachín, deluvio
humongous = huge, enormous
midst = medio, entre
crossbreed = híbrido, mestizo, mezcla
babysit = cuidar a los niños, cuidar de niños, hacer de canguro
chrysalis = crisálida, aparecimiento de crisálida
crane = grúa, grulla, estirar, levantar con grúa, realizar una grúa
slither = deslizarse, ondular, ir rodando, deslizan
prey = presa, víctima, atacar, aprovecharse de, alimentarse
quicksand = arena movediza
claw = garra, uña, gancho, garfio, oreja
fist = puño, puñar
drifter = cagabundo, trainera, soltero
pickle = escabeche, adobo, aprieto, conserva en vinagre, diablillo, baño de ácido para desoxidar
lees = poso, heces de vino
drunkard = borracho, ebrio, borrachín, espita, hecho una cuba
bow = arco, proa, lazo, reverencia, inclinación, saludo, arco iris
knee = rodilla, dar un rodillazo
deed = escritura, hecho, acción, acto, hazaña, título de propiedad, paso
tatter = andrajo
uncouth = tosco, grosero
spoil = estropear, echar a perder, mimar, deteriorar, echarse a perder, estropearse, malograr
scond = regaño, regañona, gritar
endure = soportar, aguantar, resistir, perdurar, durar, sobrellevar, tolerar
leisure = ocio, libre, tiempo libre, tiempo sin preocupación, de sport, de deporte
abide = acatar, permanecer, morar, soportar, atenerse a, tolerar, someterse a, mantener, aguantar, esperar
seafarer = marinero, navegante
subside = disminuir, calmarse, bajar, hundirse, amainarse
erode = erosionar, corroer, suceder la tierra
starve = morir de hambre, padecer hambre, privar de comida, hacer morir de hambre
edible = comestible
flatter = halagar, adular, lisonjear, favorecer, incensar
relish = saborear, paladear, gustar de, tener buen apetito para, condimento, gusto, salsa, sabor
nosebleed = hemorragia nasal
cuisine = cocina, comida
raid = redada, incursión, ataque, asalto, bombardeo, batida, correría, razzia, excursión
fungus = hongo, fungo
pot = olla, bote, maceta, tiesto, tarro, puchero, marmita, nasa, orinal, premio
blid = ciego, cegado, obcecado, falso, a ciegas, persiana, toldo
hostage = rehén
dare = atreverse, osar, desafiar, arriesgar, hacer frente a, llamar a, atrevimiento, desafío
jiffy = periquete, instante, momentito, trozo de tiempo
reef = arrecife, escollo, arrizar
breakwater = rompeolas
whirlpool = remolino, torbellino
hurl = lanzar, arrojar, tirar algo, lanzamiento
steam = vapor, humo, vaho, de vapor, cocer al vapor, empañar, echar vapor
tide = marea, corriente, marcha, progreso, tendencia que ocurre, arrastrar con la marea
debris = escombros, ruinas
dodge = esquivar, evadir, capear, hurtar el cuerpo, esquivarse, dar un esguince, regate, truco
elder = anciano, mayor, saúco, dignatario, viejo
yearn = añorar, ansiar, suspirar, desalarse
reminisce = reminisce, contar viejos recuerdos, recordar viejas historias
spitting = escupir
peddler = vendedor ambulante, buhonero
petty = pequeño, mezquino, quiquilloso
tease = molestar, embromar, atormentar, tentar, probar, tomar el pelo a, jorobar, cardar, triscar
willpower = fuerza de voluntad
rampage = alboroto, alborotar, desmandarse, comportar como un loco
flippant = ligero, poco serio, posible
notch = muesca, corte, mella, mellar, entallar, cortar muescas en
stride = paso, zancada, tranco, andar a tracos, montar a horcajadas
foster = fomentar, promover, criar, acoger a una familia
skyfall = aguacero
lean = apoyarse, inclinar, recostarse, recostar, ladear, magro, flaco, enjuto, de carestía, carne magra
dire = terrible, horrible, calamitoso, horrendo, fatal
slough = mudar, desprenderse de, mudar la piel, deshacerse por, abismo, fangal, camisa
buck = dólar, macho, macho cabrío, petimetre, brinco, ficha, corcovear, empeñarse, cargar, resistir porfiadamente a, dar sacudidas
headlight = faro, luz delantera, luz principal, luz de cabeza
overdue = atrasado, con retraso, vencido y no pagado
crumble = desmoronarse, desmenuzar, caer, desmigar
faint = débil, tenue, ligero, pálido, desmayado, vago, desfallecido, desmayarse, pasmar, perder el conocimiento, desmayado
spotlight = foco, luz concentrada, faro auxiliar, destacar, iluminar
facade = fachada, cara
lousy = piojoso, malísimo, horrible, asqueroso, terrible, vil
rake = rastrillo, libertino, rastro, calavera, hurgón, rastrillar, barrer, hurgar, examinar, registrar por, buscar en
lawn = césped, pasto
whistle = silbar, pitar, silbato, silbido, pitido, pito, silbo
dysfunction = disfunción
rogue = pícaro, pillo, truhán, picaruelo
bandit = bandido, bandolero
heal = sanar, curar, remediar, cicatrizarse, remediar a
selfish = egoísta, interesado
hoist = montacargas, grúa, izar, levantar, alzar, enarbolar
lap = vuelta, regazo, rodillas, falda, etapa, solapa, circuito, fase, traslapo, lamer, traslapar, correr
torn = desgarrado, estropeado
shelter = abrigo, albergue, amparo, asilo, cobertizo, garita, albergar, proteger, resguardarse, abrigar, amparar
oblige = obligar, complacer, forzar, hacer un favor a
clutch = embrague, apretón, crisis, agarrar, embragar, apretar, empuñar, morder
moonlit = iluminado por la luna, de luna
wage = salario, jornal, pago, premio, librar, hacer la guerra, proseguir, dar sobre, salarial
sickle = hoz
brag = jactarse, alardear, jactarse, fanfarronear, rajar, relamerse, alarde, jactancia, fanfarronada
scum = escoria, espuma, nata, hez, verdín, telilla, espumar, desnatar, quitar la escoria de
acorn = bellota
huddle = corrillo, grupo, montón, corro, amontonamiento, confusión, acurrucarse, amontonar, poner muy juntos
rendezvous = cita, lugar de una cita, reunirse con, verse, efectuarse una reunión especial
underling = subordinado
shred = hacer trizas, pizca, fragmento, jirón, tira, chispa, despedazar, hacer trizas, desfibrar, cortar en tiras
shook = sacudió
beget = engendrar, procrear, causar
thwart = frustrar, desbaratar, estorbar, impedir a, bancada
eavesdrop = escuchar a escondidas, orejar, eavesdropping: escuchas ilegales
squelch = silenciador, aplastar, chapotear
lay = poner, colocar, echar, imponer, tender, presentar, preparar, laico, lego, seglar, tendido
clash = choque, enfrentamiento, conflicto, encuentro, fragor, estruendo, desacuerdo, chocar, enfrentarse, batirse
smash = choque, rotura, accidente, quiebra, estruendo, aplastar, romper, destruir
outlaw = poscrito, forajido, bandido, proscribir, ilegalizar, declarar ilegal, encartar
lame = cojo, lisiado, poco convincente, flojo, incapaz, defectuoso, lisiar, dejar cojo, incapacitar, encojar
lung = pulmón
lodging = alojamiento, hospedaje, aposento
woozy = mareado, mareado y confuso
tame = domar, domesticar, amansar, reprimir a, manso, domesticado, dócil, domado, aburrido
adjourn = aplazar, levantar, suspender, pasar, dilatar
leper = leproso
whirlwind = torbellino, tromba, manga de viento
lowly = humilde, moderado, humildemente, moderadamente
shove = empujón, empuje, empellón, empujada, empujar, meter
stalk = tallo, pie, troncho, pezón, cazar al acecho, seguir los pasos a, andar con paso majestuoso
shun = rehuir, huir de, esquivar, descartarse de
despise = despreciar, menospreciar
spiel = rollo, arenga, relato con que uno procura convencer a otro
trait = rasgo, característica
consent = consentimiento, beneplácito, sentimiento común, consentir, sentir juntos, sentir con otra persona
tear = rasgar, arrancar, desgarrar, rasgarse, despedazar, partir, quebrar, arruinar, lacerar, lágrima, rasgón
content = contenido, cabida, descripción, índice de materias, contento, satisfecho, con cara contenta, contentar, satisfacer
wit = ingenio, saber, inteligencia, agudeza, talento, gracia, juicio, entendimiento, sal, chistoso
glare = deslumbramiento, brillo, mirada penetrante, luminosidad, mirada feroz, deslumbrar, mirar ferozmente, echar fuego por los ojos
tug-of-war = lucha de la cuerda, lucha, tira y afloja
ward = sala, pupilo, tutela, custodia, distrito electoral, guarda, crujía, guardar
sore = llaga, úlcera, herida, matadura, recuerdo doloroso, dolorido, inflamado, grande, que duele, enconado
ordeal = ordalías, experiencia penosa, prueba rigorosa
crude = crudo, bruto, tosco, vulgar, habitual
manly = varonil, viril, masculino, valiente, fuerte
stiff = cadáver, fiambre, rígido, duro, fuerte, estirado, entumecido, tenaz, espefo, frio
rowdy = quimerista, gallito, ruidoso, bullicioso, pendenciero, alborotadero, estrepitoso
pent-up = encerrado, reprimido
chill = enfriar, enfriarse, resfriarse, helar, frío, escalofrío, gelidez, frío
hasty = apresurado, ligero, impaciente, atropellado, arrebatado, inconsiderado, que tiene genio, desalado
outmaneuver = superar en la táctica
whim = capricho, antojo, veleidad, albedrío, extravagancia
flesh = carne, pulpo 
strike = golpear, atacar, pegar, herir, impresionar, acuñar, dar con, percutir, morder, encenderse, tomar, huelga, ataque, paro, golpe, descubrimiento
oath = juramento, blasfemia, palabrota, reniego
caster = castor, salero, azucarero, espolvoreador, ruedecilla de mobiliario
upheaval = convulsión, solevantamiento
harbinger = anunciar, presagio, precursor, heraldo, nuncio
forsake = abandonar, dejar, renunciar de, renegar de
picky = difícil
wary = cauteloso, escaldado
hardship = privación, sufrimiento, apuro, infortunio, penas, prueba
nagging = quejas, importunar, críticas, persistente, regañón, criticón, marimandón, continuo, nada tranquilo
shower = ducharse, derramar, llover, colmar, granizar, ducha, lluvia, chaparrón, diluvio, granizada, avalancha, nevada
footage = metraje del cine, distancia en pies
log = anotar, apuntar, registrar a, cortar troncos, log, tronco, logaritmo, leño, corredera, madero, abreviatura de logaritmo
cliff = acantilado, precipicio, farallón, monte
cliffhanger = idiom: create a lot of suspense
hazy = brumoso, confuso, calinoso, vagante
prime = cebar, preparar, imprimar, emborrachar, informar de antemano, prima, flor de la vida, virgulilla, albor, primera posición, principal, primo, primero, de primera calidad, original
puffer = fumador, locomotora
porcupine = puerco espín
sweat = sudar, explotar, sudor, trabajo difícil
pows = prisioneros de guerra
joint = articular, unir, juntar, ensamblar, cortar, articulación, junta, unión, empalme, conyuntura, juntura, conjunto, común, mixto, colectivo, mancomunado
brawn = músculo, queso de cerdo, fuerza muscular, carne de cerdo adobada
surrender = rendirse, entregar, entregarse, rendir, dar, entrega, rendición, renuncia, abandono, capitulación, cesión
betrayal = traición, engaño, revelación
betray = traicionar, delatar, engañar, defraudar, revelar a, demostrar a
deceit = engaño, mentira, fraude, falsedad, palabra falsa
falsehood = falsedad, mentira
toil = trabajar, afanarse, fatigarse, avanzar, apurarse, currelar, caminar, marchar, esfuerzo, trabajo, fatiga, afán, labor
gleam = brillar, relucir, destellar, destello, rayo, chispa, vislumbre, viso
mist = empañar, nublarse, nublar, velar, niebla, neblina, bruma, vaho, nube, velo, paño
thug = matón, gamberro, rufián vicioso
pup = parir, cachorro, cría de foca, mocoso
fodder = pensar, forraje, pienso, pasto
scourge = azotar, flagelar, atormentar, azote, látigo, castigo
fella = chico
downheart = desánimo
foe = enemigo, rival
booby = bobo, último
whet = afilar, despertar el apetito
smack = oler, pegar, dar una manotada, tener un saborcillo un poco raro, golpe, heroína, palma, sabor, queche, manotada, sabor mal, tentativa
shuttle = lanzadera, volante, vehículo que hace trayectos regulares entre dos puntos, trayector corto y regular entre dos puntos, ir y venir, transportar en
ruckus = lío
herald = anunciar, proclamar, preconizar, heraldo, anunciador, precursor
put up = poner, aguantar, colocar, levantar, presentar, montar, construir, hacer, colgar, oponer, pegar, alojar, apostar, alzar, exponer, izar
sake = sake, bien, motivo
fang = colmillo, cuchillo, teja
cloak = encubrir, ocultar, disimular, cubrir, encapotar, capa, manto, capote, pretexto, prepalabra
manifold = colector, tubo múltiple, múltiple
scout = explorar, rechazar, hacer un reconocimiento, hacer una batida, explorador, escucha, criado, observador, tipo poco visto
weep = llorar
blossom = florecer, floar, florecimiento
wilt = querer
wilts = marchita
nasty = repugnante, asqueroso, horrible, sucio, feo, antipático, grave, peligroso, grosero, indecente, obsceno, malévolo, recoroso, puerco, poco afable
pawn = empeñar, pignorar, garantizar, dejar en prenda, peón, prenda, rehén, garantía, fantoche, columnata
gaze = mirar con fijeza, mirada, contemplación
solace = consolar, consuelo, solaz
expendable = reemplazable, sustituible, que se puede sacrificar, que no es insustituible
exert = ejercer, esforzar, hacer ejercicios
tile = azulejo, baldosa, teja, sombrero, embaldosar, tejar, cubrir de tejar, adornar con azulejos
flip = poco serio, capirotazo, echar de un capirotazo
counter = contrarrestar, oponerse, contraatacar, realizar contraataque, en contra, contador, mostrador, lo opuesto, ayudante
cater = abastecer, proveer, transigir
reckoning = ajuste de cuentas, cálculo, cuenta
drift = deriva, rumbo, corriente, desvío, montón, río, acumulación, flotar, ir a la deriva, fluir, irse a la deriva
deputy = diputado, suplente, delegado, representante, lugarteniente, sustituto, comisario
bothersome = molesto, fatidioso
brash = escombros, temerario, descarado
spot = manchar, reconocer, encontrar, notar, descubrir por, lugar, punto, sitio, mancha, espacio, parte, gota, lunar, grano, peca, pinta, poquito, al contado
stuck = atascado
turmoil = confusión, tumulto, desorden, alboroto, disturbio, trastorno, estruendo, barahúnda, baraúnda
set out = exponer, emprender, partir, presentar, salir, disponer, proponerse, ponerse en camino, declarar, adornar, bajar, ordenar, espaciar
bookworm = ratón de biblioteca, polilla que roe los libros
jamming = interferencia
artful = ingenioso, astuto, diestro, solapado, engañador, arredomado
surveillance = vigilancia, supervisión, inspección
bondage = esclavitud, cautiverio
clump = pisar fuerte, andar pesadamente, grupo, macizo, mata, grupo de árboles
tend = tender, atender, cuidar, inclinarse, tener tendencia, mantener, manejar, guardar, operar
engage = contratar, atraer, acoplar, engranar, abordar, engancharse, ocupar, atacar, emplear, embragar, ajustar
haste = precipitar, tener prisa, prisa, precipitación
blast = arruinar, explotar, acabar con, abrir, volar en, marchitar, seguir disparando, salir pitando, explosión, ráfaga, chorro, estallido
cling = adherirse, pegarse, quedar pegado
tacky = pegajoso, vulgar, cursi, destartalado, raído, feo, malo, estrafalario, enfermo, malísimo
illness = enfermedad, mal, dolencia, indisposición
cherish = apreciar, querer, abrigar una esperanza
dying = moribundo, agonizante, mortecino
dwell = morar, habitar, fijarse en, vivida
bestow = atorgar, conferir, dedicar, hacer, colocar, dar de
pal = camarada, mano, cúmbila
baton = batuta, testigo, porra, bastón de mando
jumble = mezclar, emburujar, revolverse para, involucrar, revoltijo, confusión, jaleo
fumble = manoseo, manosear, dejar caer, buscar a tientas, revolverse para
shelve = dejar de lado, arrinconar, poner en un estante, poner estantes en, dar carpetazo a
dimwit = imbécil, tonto, tontorrón
recoil = recular, retroceder de, rebufar, retroceso, culatazo, rebufo
decay = decaer, pudrirse, pudrir, deteriorar, decaimiento, decadencia, caries, pudrición, corrupción
wield = ejercer, empuñar, esgrimir
feat = hazaña, proeza
blistering = abrasador, mordaz, candente
elongate = alargar, alargado
beacon = balizar, guiar, faro, baliza, guía, almenara
pledge = compromiso, prenda, garantía, pignoración, empeño, prometer, comprometerse, empeñar, jurar, dar en prenda
stoop = agacharse, inclinarse, encorvarse, bajar, pórtico, cargazón de espaldas, pequeña veranda
kid = engañarse, bromearse, chunguearse, chacotear, tomar el pelo, niño, cabrito, chico, chaval, joven, de niño, de cabrito
babble = balbucear, parlotear, farfullar, murmurar, cotillear, revelar a, balbuceo, parloteo, murmullo, cháchara, farfulla
scorch = quemadura, quemar, chamuscar, quemarse, herir, arrasar, ir volando
swath = andana
blunt = embotado, franco, obtuso, desafilado, despuntado, terminante, pompo, embotar, despuntar
stab = apuñalar, puñalada, estocada, pinchazo, herida, tentativa
pierce = atravesar, agujerear, penetrar en, taladrar, herir, conmover, entrar en
sew = coser, encuadernar
boil = hervir, cocer, bullir, pasar por agua, hervor, furúnculo, punto de ebullición
whine = gimoteo, quejido, silbido, gimotear, silbar, gañir, decir de
attrition = desgaste, atricción, roce
foul = sucio, falta, faltado, asqueroso, sucio, fétido, vil, horrible, viciado, feo, infecto, indecente
skirmish = escaramuzar, pelear, escaramuza, pelea, encuentro, agarrada
ironclad = acorazado
brazen = descarado, de latón, bronceado, bronco, lanzado, zafado
coop = cooperativa, gallinero, hombre gallina, captar gallinas
harm = daño, perjuicio, mal, dañar, perjudicar, hacer daño a, estropear, sufrir daños, hacer mal a
nock = hacer muescas en
drab = pardusco, soñoliento, monótono, gris, triste tensamente
flock = congregarse, afluir, acudir en tropel, unirse a, rebaño, manada, bandada, grey
helm = ser timón, timón
stifle = sofocar, ahogar, ahogarse, sofocarse
loathe = aborrecer, detestar, odiar
retreat = retirarse, batirse en retirada, retiro, retirada, refugio, retramiento, vuelta atrar, ejercicios
revere = reverenciar, venerar, acatar
gale = vendabal, tormenta, tempestad, ventarrón
hip = cadera, escaramujo, moderno, enterado, al día
swing = oscilar, balancearse, balancear, cambiar, columpiar, hacer oscilar, mecer, determinar, oscilación, columpio, balanceo, movimiento
ragtag = shaggy or unkempt; ragged
shaggy = peludo, lanudo, enmarañado, desgreñado, velludo, tupido, cubierto de maleza, con pelusa
unkempt = desaliñado, desgresado
rag = dar guerra a, tomar el pelo a, guasearse, bromearse, trapo, harapo, periodicucho, andrajo, novatada
ensue = sobrevenir, seguirse, pasar, resultar que
ramp = rampa, desnivel, estafa
itch = picar, hormiguear, sentir comezón, tener a, rabiar, desear vehementemente, picazón, comezón, prurito, sarna
rein = rienda, refrenar
shirk = eludir, rehuir, evitar, escamotear, esquivarse, escurrir el bulto, fumarse, hacer el vago
upside = al revés
chop = cortar, picar, tajar, talar, partir, desmenuzar, tajada, chuleta, golpe cortante, boca, cambio
one-off = único, aislado, irrepetible
quote = citar, cotizar, entrecomillar, expresar, hacer citas, dar para, cita
overhead = arriba, encima, en alto, por lo alto, por encima de la cabeza, superior, de arriba, aéreo, de techo, suspendido, superpuesto
concern = preocupación, asunto, empresa, cuidado, referirse, preocupar, concernir, inquietar, ocupar
unbusinesslike = poco práctico, informal, poco metódico, que carece de instinto comercial
oil = aceite, petróleo, óleo, crisma, caldos, santo óleo, engrasar, aceitar, lubricar, pintar, enaceitar
fuel = combustible, carburante, leña, carbón, pábulo, energético, aprovisionar de combustible, estimular, avivar, provocar, acalorar
disrupt = interrumpir, desorganizar, quebrantar, desvertebrar, dar al traste con, desbaratar planes, trastornar la cabeza
slippage = deslizamiento
plow = arar, surcar, abrir, ararse, acanalar, guillotinar, cargar, trabajar con una guillotina, arado, tierra arada, guillotina, guimbarda
blizzard = ventisca, tempestad de nieve
loaves = panes
chaff = burlar, tomar el pelo a, paja, barcia, paja menuda, bagazo, burlas
tinsel = oropel, lama de oro, de oropel, de relumbrón
magi = los reyes magos
pat = palmadita, caricia, porción, acariciar, dar palmaditas, tocar, dividir en porciones, oportuno, adecuado, oportunamente
handcuff = esposar, maniatar
nap = echar el guante a, coger, prender
silk = seda, toga, estigma del maíz, de seda, sedero, madurar
elate = rigocijado, regocijar
freakish = monstruo, anormal, caprichoso, imprevisible, fortuito, inesperado
showmanship = tentralidad, exhibicionismo, talento para organizar espectáculos
skunk = mofeta, canalla, dar una paliza de
hindsight = retrospectiva, comprensión retrospectiva
onus = carga, deber, culpa
derrick = derrick, torre de perforación, grúa, pozo de petróleo
rag = dar guerra a, tomar pelo a, guasearse, bromearse, trapo, harapo, periodicucho, novatada
hogging = acaparando, grava, curvidad
sprung = agrietar, resquebrajadura, cubrición, cuarteo, arrafadura, fisura, rotura, hendedura, rompimiento, salto, raja, grieta, brinco
tick = marcar, tildar, hacer tictac, poner una señar contra, garrapata, tictac, palomita, marca de aprobación, fiado, momento, instante, rato, funda de colchón, crédito
tickle = cosquillear, hacer cosquillas, acariciar, divertir, hacer gracia a, chiflar, gato
goody = bueno, golosina, bonachón, santurrón, beatuco
rousing = conmovedor, emocionado, vivo
hooey = nonsense
betcha = "bet you"
stare = permanecer
huff = jadear, rabieta
puff = soplar, jadear, echar humo, echar bocanadas de, dar chupadas a, echar vapor, soplo, bombo, borla, racha, resoplido
outtake = descarte
cling = adherirse, pegarse, queda pegado
frankincense = incienso
thorny = espinoso, pantanoso
myrrh = mirra
anoint = ungir, untar
genus = género, tipo
gum = goma, chicle, encía, cola, pegamento, cemento, engomar, pegar con cola
waist = cintura, talle
brownie = duende, bizcocho de chocolate y nueces
writhing = retorciéndose
off the beat = fuera de tiempo
raft = embalsar, balsa, serie, montón, almedía, cantidad, grupo
chestnut = castaño, chiste viejo 
ensnare = entrampar
eerily = inquietantemente
striking = llamativo, notable, chocante, acusado
probing = sondeo, exploración, toma de muestras, penetrante, minucioso
tampered = manipulado
wordy = verboso
glimpse = vislumbrar, entrever, otear, vislumbre
testbed = banco de pruebas
adaptive = adaptado
dawn = amanecer, alborear, comenzar, romper el día, amanecer, alba, madrugada, aurora, alborada, nacimiento
annealing = recocido
soften = ablandar, amortiguar, ablandarse, mitigar, suavizarse, debilitar, emblandecer
brittle = frágil, quebradizo, deleznable, susceptible
melt = fundir, derretirse, fundirse, disolverse, ablandar
molten = fundido, derretido, líquido
plateau = meseta, altiplano
behemont = gigante
jeopardy = peligrar, comprometer, poner en peligro, arriesgar, ocasionar, dañar, peligro, daño
arsonist = incendiario
nod = cabecear, mover, inclinar, dar cabezadas, inclinar la cabeza, inclinación de cabeza, cabezada
kick = patear, golpear, dar patadas, dar una patada, cocear, marcar, patada, tiro, puntapié, golpe
hiccup = hipo, hipar, tener hipo, decir hipando
fad = moda, novedad, manía, ley
roof = techo, tejado, cielo, baca, marquesina, bóveda, techar, poner techo a
slouchy = desgarbado
sob = sollozar
piss = mear, hacer pis, meada, pipí
forge = forjar, falsificar, fraguar, falsear, contrahacer, forja, fragua, herrería, fundición
seep = filtrarse, colarse, rezumarse
crack = agrietar, grieta, abertura, golpe, crac, crujido, hendedura, estallido, quebradura, agrietarse, agrietar, quebrar, rajar
swifter = más rápida
mettle = brío, ánimo
assort = clasificar, cuadrar, arreglar, ordenar, corresponder
assorted = clasificado, surtido, variado
whom = quién
revile = injuriar, vilipendiar
thrash = golpear, trillar, apalear, azotar, zurrar, fustigar, dar una paliza, dar golpes, cascar, mover violentamente, movimiento de piernas, guateque, velada
bind = enlazar, obligar, atar, ligar, encuadernar, unir a, aprisionar, liar, fraguar, trabarse, hacer, rematar, ceñir, vincular con, lazo, atasco, lata
gourd = calabaza, mate
trickery = astucia, trampa, superchería, fraude, mañas, treta, chanchullo, agachada
drivel = decir tonterías, mentiras
goner = desahuciado
expell = expeler
subdue = dominar, sojuzgar, rendir, suavizar, doblar
weakling = alfeñique, cobarde, persona débil, enfermizo, mandria, ser delicado, emplasto, redrojo
kinda = un poco
touted = pregonar, ofrecer, revender, solicitar, clientes, tratar como
peel = pelar, pelarse, mondar, descortezar, descascarillar, piel, corteza, monda, pala, pellejo
plating = enchapado, blindaje, capa metálica
retreat = retirarse, batirse en retirada, retiro, retirada, refugio, retraimiento, vuelta atrás, ejercicios, casa de ejercicios
voice = expresar, decir, sonorizar, hacer eco de, voz, laríngeo
possum = zarigüeya
snorkel = nadar respirando por un tubo, esnórquel, tubo de respiración, tubo esnórquel
impervious = impermeable, impenetrable, insensible, impasible a
staunchly = incondicionalmente
warp = deformar, deformarse, alabear, alabearse, pervertir, afectar, torcer fuertemente, urdimbre, deformación, comba, alabeo, pandeo, sesgo
diminish = disminuir, desminuirse, achicar, hacer menos
blow = soplar, volar, sonar, tocar, fundir, soplarse, echar, fundirse, inyectar, quemarse, resoplar, golpe, soplo, palmetazo, ráfaga de viento, información
renown = renombre, fama, nombradía
stain = manchar, teñir, mancharse, pintar, mancha, tintura, borrón, tinte de color
swordsmanship = esgrima
smear = manchar, desprestigiar, calumniar, mancharse, embarrar, derrotar sin fuerzo, enlomar, frotis, mancha, calumnia
sac = saco, bolsa
fellow = compañero, miembro, tipo, prójimo, sujeto, chico, socio, tío, igual, pareja
defy = desafiar, oponerse a, resistir a, contravenir a, mandar una llamada
hereby = por la presente, por este medio, por eso
wavering = vacilar, flaquear, dudar, oscilar, fluctuar, ondear, vibrar, encasquillarse
stringy = fibroso, lleno de fibras
pout = poner mala cara, abadejo, mala cara
bark = ladrar, descortezar, gritar, rugir, despellejar, curtir, toser, ladrido, barca, conteza de árbol, casca, bricbarca, estampido
rile = sacar de quicio, sulfurar, encabronar, reventar en, encabritar
amuck = locura, loco, destruyendo
inflict = infligir, causar, inferir, molestar, imponer en
injury = lesión, daño, herida, prejuicio
shrewd = perspicaz, hábil, listo, penetrante, fino, juicioso
puny = escuchimizado
sap = minar, zapar, agotar, savia, bobo, zapa, zanja, memo
defeat = derrotar, vencer, frustrar, anular, rechazar, rendir, defraudar, estorbar, derrota, vencimiento, anulación, rendición
prowess = valor, proeza, habilidad
stalemate = ahogar, paralizar, estancamiento, paralización, tablas
vejiga, vesícula, cámara de aire
imprint = imprimir, grabar, estampar, huella, impresión, pie de imprenta, estampa
weed = eliminar, escardar, desherbar, deshierbar, arrancar, quitar, sachar, mala hierba, tabaco, yerbajo, cigarrillo, madeja
rage = rabiar, enfurecerse, bramar, desencadenarse, estar furioso, doler atrozmente, rabia, ira, furor, boga, manía
owl = búho, lechuza, mochuelo, cárabo, múcaro
scent = permumar, oler, olfatear, olor, perfume, rastro, olfato, pista
jerky = tipo espasmódico, tipo nervioso, tipo desigual, espasmódico
mutt = chucho, perro callejero, bobo, papanatas
misgiving = recelo, duda, temor, presentimiento
qualm = escrúpulo, remordimiento, náusea, duda, mareo
chivalrous = caballeresco, caballeroso
woven = tejer, entrelazar, urdir, trenzar, tramar, abrirse, evadirse
shed = derramar, perder, despojarse de, mudar, quitarse, verter a, traer a, deshacerse por, despedirse de, cobertizo, nave, hangar, almacén, tinglado, establo, barraca
digression = digresión, divagación, caída, bajada
scrap = desechar, desguazar, descartar, pelearse, chatarra, trozo, recorte, pelea, ápice, movida, chirinola
daunting = acobardar, desalentar, arredrar, intimidar de
knit = tejer, tricortar, hacer punto, soldarse, fruncir, hacer calceta, hacer media, unirse en, hacer a punto de aguja
arcane = arcano, secreto
ascribe = atribuir, imputar
uprise = levantarse, insurreccionar, sublevar
royal = persona real, real, regio,magnífico
tremble = temblar, estremecerse, temblor, estremecimiento
awe = atemorizar, impresionar, imponer en algo, temor, admiración
clay = arcillar, arcilla, barro, greda
soil = ensuciar, manchar, ensuciarse, emporcar, suelo, tierra
smug = presumido, pegado de sí
dud = falso, inutilidad
bedrock = base, fundamento, roca de fondo
screw = atornillar, joder, apretar, follar, enroscarse, sacar, retorcer, tornillo, tuerca, hélice, polvo, tacaño, sueldo, penco, carcelero
vulture = buitre
pleas = súplica, petición, alegato, pretexto, excusa
murk = oscuridad, tinieblas, tenebroso, oscuro, turbio, lóbrego
jug = meter, enchironar, poner, jarra, cántaro, chirona
vouch = atestiguar, garantizar, confirmar, afianzar, garantir, responder por
granny = abuelita
overpower = dominar, vencer, subyugar, sobreponerse a, asir y tener quieto
overpowering = abrumador, arrollador
bump = golpear, chocar contra, darse un golpe, mantear, enerezar, dar sacudidas, chichón, bulto, bache, batacazo, zarpazo, porrazo, trastazo
behead = decapitar, descabezar, degollar
lariat = lazo, reata
pounce = saltar, precipitarse, estarcir, atacar, súbitamente, estampar en relieve, salto, cisquero, garra, arenilla, salto repentino
void = vacío, hueco, espacil falla, vacío, nulo, inválido, vacante, vacuo, desocupado
singlehandedly = sin ayuda
preach = predicar, sermonear, pronunciar, aconsejar, dar un sermón
helmet = casco, escafandra
downhill = en declive, en pendiente, cuesta abajo
thrust = empujar, impulsar, clavar, meter, asestar, abrirse, hincar, introducirse, enterrar, impeler, empuje, estocada, avance, ataque, dinamismo, idea clave, lanzada, cuchillada
stopgap = recurso provisional
truce = tregua
budge = ceder, moverse, mover, hacer ceder
showdown = confrontación, momento decisivo
vent = desahogar, expresar, purgar, desfogar, emitir, respiradero, abertura, cloaca, válvula, orificio, ventosa
envoy = enviado
chip = astillarse, desportillarse, desconcharse, desconchar, desportillar, chip, ficha, astilla, pastilla, circuito integrado, fragmento, patatas fritas, pedacito
ushered = acompañar, hacer pasar, hacer entrar
festers = enconarse, ulcerarse, amargarse
beseech = implorar, rogar a
bygone = pasado, cosa pasada
waltz = vals, waltzed: bailado
swift = vencejo, rápido, pronto, ligero, repentino
homeland = patria, tierra natal, bantustán
seek = buscar, solicitar, pedir, procurar
scalpel = bisturí, escalpelo
downstairs = abajo, en el piso de abajo, piso inferior, parte de abajo, de abajo, del piso de abajo
pendant = colgante, pendiente, dije, lámpara colgante, pareja, grímpola, pendiente, que sobresale
fearsome = temible, temoso
decoy = entruchar, atraer con señuelo, proclamar, señuelo, cimbel, reclamo, entruchón, proclamo
bolt = empernar, desbocarse, echar el cerrojo, cerner, engullir, abandonar, retirarse, tornillo, cerrojo, pestillo, rayo, rollo, pieza, huida
crisp = crujir, rizarse, cosa crespa, dinero falso, crujiente, fresco, crespo, rizado
cautious = cauteloso, prudente, cauto, precavido, atentado
behold = observar, considerar, advertir
slice = cortar, rebanar, golpear, rebanada, rodaja, porción, trozo, tajada, parte, raja, lonja, rajita
lick = lamer, besar, derrotar a, azotar, dar una paliza, dar un beso, lamedura, lengüetazo, legüetada
marsh = pantano, marisma, ciénega, ñanga
lid = tapa, párpado
pipe = chillar, tocar el caramillo, conducir por tubería, encañar, encanalar, transportar por oleoducto, instalar tuberías en, tubo, pipa, conducto, cañería, cañon
barren = tierra yerma, estéril, árido, infecundo, seco, infructuoso
storehouse = almacén, depósito, mina
fatso = gordo
covet = codiciar, desear, anhelar, ansiar
ear = oído, oreja, espiga, asa, escuchador
eyebrow = ceja, globo ocular
wisp = jirón, fragmento, manojito, agudeza, ingenio
borne = tener, soportar, llevar, dar, portar, dar a luz, parir, aguantar, sostener, guardar, pagar, producir, devengar, padecer, resistir, ejercir, admitir
scramble = mezclar, pelearse, perturbar, revolverse a, trepar arrastrándose, lucha, camino difícil, arrebatiña, carrera de motos
netherworld = underworld
burden = cargar, gravar, agobiar, carga, peso, gravamen, agobio, estribillo, arqueo, tema central
wraith = fantasma
tight-lipped = callado, hermético
bequeathed = legar, testar
easygoing = acomodadizo, sencillo, indolente, nada severo
stink = oler mal, heder, hedor, tufo, hediondez, lío, follón
abhor = aborrecer, abominar, detestar, odiar
egotistical = ególatra, egotístico
shoulder = cargar con, llevar en hombros, empujar con el hombro, echarse al hombro, hombro, espaldilla, andén, rellano, desnivel
mirage = espejismo
clam = almeja
wispy = ralo
whisker = bigote
awkward = ñango, torpe, incómodo, difícil, embarazoso, desgarbado, pesado, poco manejable
